+++++++++++++++++++++++++++++++++++++++++++++++++++++++++++++++++++++++++++++++++++++++++++++
e       +   + + + + +     +     +     + +     +     +       +     +       +     +         + +
+ +++++ + + + + + + +++++ + + +++ +++++ + +++++++++ + +++ +++ +++++ + +++ +++ +++ +++++++++ +
+ +   + + +         +     + +   + + +   +     + +       + +   +   + +   + +   + + +   +     +
+ + +++ + +++ +++ +++++++ +++ + + + +++ +++++ + +++ +++++ + +++ +++++ +++++ + + + + +++ + + +
+ +       +   +     +   + +   + +   + +   +         +     +   +   + +     + +   +   +   + + +
+ +++++++++++ +++++ + +++ +++ + +++ + +++ +++++++ +++ + + + +++++ + + + +++++ + + + + + +++ +
+   +       +   +         +   +       + + + +     +   + + + +     +   +       + + +   +   + +
+ +++++ + +++++ +++ +++++++++ + +++++ + + + + +++++ + + +++ + + +++ +++ +++ + + +++ + +++++++
+     + +   +     + +   +   + + +       +         + + +       + + +   + +   + +   + +   +   +
+ +++++++ + +++++ + +++ + +++++ + +++ +++++++ +++++++ +++ + +++++ +++++++++++ +++++ +++++++ +
+ +   +   + +   + + + +   +     + +           +   +     + + +   + + + +   +     + +   +   + +
+++ + + +++++ +++++ + + +++ +++++++++ +++ + + + +++++ +++ +++++ + + + +++ + + + + + +++ + + +
+ + + + +   +   +           +         + + + + +   + + +     +   + + + +   + + +     +   + + +
+ + + + + + +++ + + +++++++ + + +++ +++ + + + +++ + +++ +++ +++ + + + + + + + + + +++++ +++ +
+ + +   + +   +   +       + + + + +     + + + +     + + + +           + + + + + + +   +     +
+ + +++++++++ +++ +++ +++++++++++ + +++++++ + +++ +++ + + +++++++++ + + + + +++++++ +++++++ +
+   +       +   +   + + +   + +       +     +   + +   + + + +     + + + +     +   +     +   +
+++ +++++ + + +++ +++ + + + + + +++ + +++++ +++ + + + + + + +++++ +++++++ +++ + + + +++ +++ +
+     + + + +       +   + +     +   +   +   + + +   + + + + +         +     +   +     +   + +
+++ + + + + + +++++++++++ + +++ +++++++ +++++ + + +++ + + + +++ + + +++++++++++++ + +++ + +++
+   +     +     +         + +     + + +     +   + + + + + +     + +     +   +   + + +   + + +
+ +++++ +++ + +++ + +++++++++ +++++ + +++++++++++++ + +++ +++ +++++ +++++++ +++ + +++ + +++ +
+   +   +   + + + +       + +             +     +       +     + +   +           +   + +     +
+++ + +++ +++ + +++++++++++ +++ +++ + +++++++++ + +++++++ +++++ + + +++++++ + +++++ +++ + + +
+   + +   + +     + +     + +     + + +     + +           +     + + +     + + +       + + + +
+++++++++++ +++++++ + +++++ +++ + +++++ +++ + +++++ +++ + +++++ +++++ + +++ + +++++ +++++ +++
+     + + +   +       + +       + +     + +     +     + +       +     + +   +   +       +   +
+++++ + + + +++++++ + + + +++ +++++++++++ + +++ +++++ +++++++++++++ +++ + +++++++ +++ +++ +++
+ +       +   +   + +     +       +   +       +   +       +     + + + +   +   +   +     + + +
+ + + +++ + +++++ +++++ +++++++++++++ +++++++++++ + +++ +++++ +++ + + +++ +++ + +++ +++++ + +
+   + +     +   + +       + +   +     +   +   +     + + +           +     + +     + + +   + +
+ + +++ + +++ +++ + +++ +++ + + + +++++ +++ +++++++ + + + +++ + +++++++++++ +++++ + + +++++ +
+ +   + +   +     + +     +   +   +     +   +     +   + +   + + + +   + +   +     +   +     +
+++ +++ +++++++ +++++ +++ +++ +++++ +++++ +++++ +++ +++++++ +++++ + +++ + +++++++++ +++++++ +
+ + +       + +     + +   +       +   +       +     + + +     + +       +       +           +
+ + + + +++ + +++ +++ + + +++++ + +++ + + + +++++ + + + + +++ + +++ + +++ +++++ +++ ++ ++++ +
+   + + +             + +       +     + + + +     + + +     +       +         +   + +     + +
+ +++ +++++ + + +++ +++ +++++++ +++ +++ +++ + +++++ + +++++ + +++++++++ +++ +++++ + + + + +++
+   +     + + + +     +     +     +       +       +         +     +     +     +       + +   s
+++++++++++++++++++++++++++++++++++++++++++++++++++++++++++++++++++++++++++++++++++++++++++++
