+++++++++++++++++++++
e   +     +       +s+
+ +++ + +++ +++ +++ +
+     + +     + +   +
+++++++ + +++++ + +++
+       + + +   +   +
+ +++++++ + + +++++ +
+       + + +       +
+ +++++ + + +++++++++
+     + + +         +
+++++ + + + +++ +++ +
+ +   +   + + + +   +
+ + +++++++ + + +++++
+ + +         + +   +
+ + + +++++++++ + +++
+ + +   +   +   + + +
+ + +++++ + + + + +++
+   +     + + + +   +
+ +++ +++++ + + +++++
+     +       +     +
+++++++++++++++++++++
