+++++++++++++++++++++++++++++++++++++++++++++++++++++++++++++++++++++++++++++++++++++++++++
e       +   + + + + +     +     +     + +     +     +       +     +       +     +         +
+ +++++ + + + + + + +++++ + + +++ +++++ + +++++++++ + +++ +++ +++++ + +++ +++ +++ +++++++++
+ +   + + +         +     + +   + + +   +     + +       + +   +   + +   + +   + + +   +   +
+ + +++ + +++ +++ +++++++ +++ + + + +++ +++++ + +++ +++++ + +++ +++++ +++++ + + + + +++ + +
+ +       +   +     +   + +   + +   + +   +         +     +   +   + +     + +   +   +   + +
+ +++++++++++ +++++ + +++ +++ + +++ + +++ +++++++ +++ + + + +++++ + + + +++++ + + + + + +++
+   +       +   +         +   +       + + + +     +   + + + +     +   +       + + +   +   +
+ +++++ + +++++ +++ +++++++++ + +++++ + + + + +++++ + + +++ + + +++ +++ +++ + + +++ + +++++
+     + +   +     + +   +   + + +       +         + + +       + + +   + +   + +   + +     +
+ +++++++ + +++++ + +++ + +++++ + +++ +++++++ +++++++ +++ + +++++ +++++++++++ +++++ +++++++
+ +   +   + +   + + + +   +     + +           +   +     + + +   + + + +   +     + +       +
+++ + + +++++ +++++ + + +++ +++++++++ +++ + + + +++++ +++ +++++ + + + +++ + + + + + +++ + +
+ + + + +   +   +           +         + + + + +   + + +     +   + + + +   + + +     +   + +
+ + + + + + +++ + + +++++++ + + +++ +++ + + + +++ + +++ +++ +++ + + + + + + + + + +++++ +++
+ + +   + +   +   +       + + + + +     + + + +     + + + +           + + + + + + +   +   +
+ + +++++++++ +++ +++ +++++++++++ + +++++++ + +++ +++ + + +++++++++ + + + + +++++ + +++++++
+   +       +   +   + + +   + +       +     +   + +   + + + +     + + + +     +   +       +
+++ +++++ + + +++ +++ + + + + + +++ + +++++ +++ + + + + + + +++++ +++++++ +++ + + + +++ +++
+     + + + +       +   + +     +   +   +   + + +   + + + + +         +     +   +     +   +
+++ + + + + + +++++++++++ + +++ +++++++ +++++ + + +++ + + + +++ + + +++++++++++++ + +++ + +
+   +     +     +         + +     + + +     +   + + + + + +     + +     +   +   + + +   + +
+ +++++ +++ + +++ + +++++++++ +++++ + +++++++++++++ + +++ +++ +++++ +++++++ +++ + +++ + +++
+   +   +   + + + +       + +             +     +       +     + +   +           +   + +   +
+++ + +++ +++ + +++++++++++ +++ +++ + +++++++++ + +++++++ +++++ + + +++++++ + +++++ +++ + +
+   + +   + +     + +     + +     + + +     + +           +     + + +     + + +       + + +
+++++++++++ +++++++ + +++++ +++ + +++++ +++ + +++++ +++ + +++++ +++++ + +++ + +++++ +++++ +
+     + + +   +       + +       + +     + +     +     + +       +     + +   +   +       + +
+++++ + + + +++++++ + + + +++ +++++++++++ + +++ +++++ +++++++++++++ +++ + +++++++ +++ +++ +
+ +       +   +   + +     +       +   +       +   +       +     + + + +   +   +   +     + +
+ + + +++ + +++++ +++++ +++++++++++++ +++++++++++ + +++ +++++ +++ + + +++ +++ + +++ +++++ +
+   + +     +   + +       + +   +     +   +   +     + + +           +     + +     + + +   +
+ + +++ + +++ +++ + +++ +++ + + + +++++ +++ +++++++ + + + +++ + +++++++++++ +++++ + + +++++
+ +   + +   +     + +     +   +   +     +   +     +   + +   + + + +   + +   +     +       +
+++ +++ +++++++ +++++ +++ +++ +++++ +++++ +++++ +++ +++++++ +++++ + +++ + +++++++++ +++++++
+ + +       + +     + +   +       +   +       +     + + +     + +       +       +         +
+ + + + +++ + +++ +++ + + +++++ + +++ + + + +++++ + + + + +++ + +++ + +++ +++++ +++ ++ ++++
+   + + +             + +       +     + + + +     + + +     +       +         +   + +     +
+ +++ +++++ + + +++ +++ +++++++ +++ +++ +++ + +++++ + +++++ + +++++++++ +++ +++++ + + + + +
+   +     + + + +     +     +     +       +       +         +     +     +     +       + + s
+++++++++++++++++++++++++++++++++++++++++++++++++++++++++++++++++++++++++++++++++++++++++++
