+++++++++++++++++++++++++++++++++++++++++++++++++++++++++++++++++++++++++++++++++++++++++++++++++++++
e       +   + + + + +     +     +     + +     +     +       +     +       +     +         +         +
+ +++++ + + + + + + +++++ + + +++ +++++ + +++++++++ + +++ +++ +++++ + +++ +++ +++ +++++++++ + + + +++
+ +   + + +         +     + +   + + +   +     + +       + +   +   + +   + +   + + +   +     + + +   +
+ + +++ + +++ +++ +++++++ +++ + + + +++ +++++ + +++ +++++ + +++ +++++ +++++ + + + + +++ + + + + +++ +
+ +       +   +     +   + +   + +   + +   +         +     +   +   + +     + +   +   +   + + + +   + +
+ +++++++++++ +++++ + +++ +++ + +++ + +++ +++++++ +++ + + + +++++ + + + +++++ + + + + + +++ + + +++++
+   +       +   +         +   +       + + + +     +   + + + +     +   +       + + +   +   + + + + + +
+ +++++ + +++++ +++ +++++++++ + +++++ + + + + +++++ + + +++ + + +++ +++ +++ + + +++ + +++++++ +++ + +
+     + +   +     + +   +   + + +       +         + + +       + + +   + +   + +   + +   +   +     + +
+ +++++++ + +++++ + +++ + +++++ + +++ +++++++ +++++++ +++ + +++++ +++++++++++ +++++ +++++++ + +++++ +
+ +   +   + +   + + + +   +     + +           +   +     + + +   + + + +   +     + +   +   +     +   +
+++ + + +++++ +++++ + + +++ +++++++++ +++ + + + +++++ +++ +++++ + + + +++ + + + + + +++ + +++++ + +++
+ + + + +   +   +           +         + + + + +   + + +     +   + + + +   + + +     +   + +   +     +
+ + + + + + +++ + + +++++++ + + +++ +++ + + + +++ + +++ +++ +++ + + + + + + + + + +++++ +++++ +++ +++
+ + +   + +   +   +       + + + + +     + + + +     + + + +           + + + + + + +   +     +       +
+ + +++++++++ +++ +++ +++++++++++ + +++++++ + +++ +++ + + +++++++++ + + + + +++++++ +++++++ +++++ +++
+   +       +   +   + + +   + +       +     +   + +   + + + +     + + + +     +   +     +   +   + + +
+++ +++++ + + +++ +++ + + + + + +++ + +++++ +++ + + + + + + +++++ +++++++ +++ + + + +++ +++ + +++++ +
+     + + + +       +   + +     +   +   +   + + +   + + + + +         +     +   +     +   +   +   + +
+++ + + + + + +++++++++++ + +++ +++++++ +++++ + + +++ + + + +++ + + +++++++++++++ + +++ + +++ +++ + +
+   +     +     +         + +     + + +     +   + + + + + +     + +     +   +   + + +   + +     +   +
+ +++++ +++ + +++ + +++++++++ +++++ + +++++++++++++ + +++ +++ +++++ +++++++ +++ + +++ + +++ + + + +++
+   +   +   + + + +       + +             +     +       +     + +   +           +   + +     + +     +
+++ + +++ +++ + +++++++++++ +++ +++ + +++++++++ + +++++++ +++++ + + +++++++ + +++++ +++ + + +++++++ +
+   + +   + +     + +     + +     + + +     + +           +     + + +     + + +       + + + +   +   +
+++++++++++ +++++++ + +++++ +++ + +++++ +++ + +++++ +++ + +++++ +++++ + +++ + +++++ +++++ +++ +++++++
+     + + +   +       + +       + +     + +     +     + +       +     + +   +   +       +   +     + +
+++++ + + + +++++++ + + + +++ +++++++++++ + +++ +++++ +++++++++++++ +++ + +++++++ +++ +++ +++ +++ + +
+ +       +   +   + +     +       +   +       +   +       +     + + + +   +   +   +     + + +   +   +
+ + + +++ + +++++ +++++ +++++++++++++ +++++++++++ + +++ +++++ +++ + + +++ +++ + +++ +++++ + +++ +++++
+   + +     +   + +       + +   +     +   +   +     + + +           +     + +     + + +   +   + + + +
+ + +++ + +++ +++ + +++ +++ + + + +++++ +++ +++++++ + + + +++ + +++++++++++ +++++ + + +++++ + + + + +
+ +   + +   +     + +     +   +   +     +   +     +   + +   + + + +   + +   +     +   +     + +   + +
+++ +++ +++++++ +++++ +++ +++ +++++ +++++ +++++ +++ +++++++ +++++ + +++ + +++++++++ +++++++ + +++ + +
+ + +       + +     + +   +       +   +       +     + + +     + +       +       +       +   + +     +
+ + + + +++ + +++ +++ + + +++++ + +++ + + + +++++ + + + + +++ + +++ + +++ +++++ +++ +++++++++ +++ + +
+   + + +             + +       +     + + + +     + + +     +       +         +   + +     +     + + +
+ +++ +++++ + + +++ +++ +++++++ +++ +++ +++ + +++++ + +++++ + +++++++++ +++ +++++ + + + + +++ +++ + +
+   +     + + + +     +     +     +       +       +         +     +     +     +       + +         + s
+++++++++++++++++++++++++++++++++++++++++++++++++++++++++++++++++++++++++++++++++++++++++++++++++++++
